実行時刻: 2024-12-15 12:13:55.387740
episode: 88
step: 92

WWWWWWWWWWWWWWWWWWWWWWW
WS^v<vv<v^vPWPWW<>^W^PW
WvWWWWWWCWWW^>Wv<WWW<WW
W^>>^^v<<<<vvvW<v^^v<^W
W<WW<W<WWWWCWWvvWWW^>WW
WvW>>WWW^W^^>^W<vWP<v>W
W>W<<<>v<WWW^vW^WWWW<WW
W>W<vW>W<>W<vWW^vCW^C<W
W>WvWWWW<WWWC^WWW<WWWvW
W<WC^W>WvWv^vWW^W^Wv^vW
W<W<vv^^v>WW>><>>>>>>vW
WC^<W>W>Wv><>>W>vWvvWvW
WWW^<><vWWvWW<WWWWvWWvW
WP^<W<W<vPWWv>WP^v>C>GW
WWWWWWWWWWWWWWWWWWWWWWW
