実行時刻: 2024-12-15 12:13:10.997948
episode: 69
step: 77

WWWWWWWWWWWWWWWWWWWWWWW
WSv><vv<v^^PWPWW<>^W^PW
W^WWWWWWCWWW<vWv<WWW<WW
W^>vv^<<^<v>v>W<v^^v<^W
W<WW>W<WWWW^WWvvWWW^>WW
W>W<>WWW^Wv<><W<vWP<v>W
W>Wv<^^C<WWWv^W<WWWW<WW
W>W<vWPW^>W<vWW>vCW^C<W
W>WvWWWWvWWW<^WWW>WWWvW
W<WC<W>WvWv^vWW<W^W^vvW
W>Wv<^v>CvWW>><>>>>>>vW
WC^>W<W<W>>C>>Wv>WvvWvW
WWWv^<>^WW<WW<WWWWvWWvW
WP^<W<W<>PWWP>WP^v>C>GW
WWWWWWWWWWWWWWWWWWWWWWW
