実行時刻: 2024-12-15 12:14:03.636151
episode: 91
step: 216

WWWWWWWWWWWWWWWWWWWWWWW
WS^^^<^^v^vPW^WW<>^W^PW
WvWWWWWW^WWW^>Wv<WWW<WW
W>vvCv<^vv^<vvW<v^^v<^W
W<WW<W<WWWW^WWvvWWW^>WW
WvW>vWWW<W^>^^W<vWP<v>W
W>Wvv<>C>WWWvvW^WWWW<WW
W>W<<WPW<>W<vWW^vCW^C<W
W>W<WWWWvWWW^^WWW<WWWvW
W<WC<W>W>Wv^<WW^W^Wv^vW
W<W^v>v>C<WW>>v>>>>>>vW
WC<<W<W>W>vC>^W>vWvvWvW
WWWv<^^>WWvWW<WWWWvWWvW
WP^<W<W<^PWWP>WP^v>C>GW
WWWWWWWWWWWWWWWWWWWWWWW
