実行時刻: 2024-12-15 12:13:17.574797
episode: 71
step: 214

WWWWWWWWWWWWWWWWWWWWWWW
WSv^^vv<v^^PWPWW<>^W^PW
W>WWWWWWCWWW<vWv<WWW<WW
W>>v<v<<^<v>v>W<v^^v<^W
W<WW>W<WWWWCWWvvWWW^>WW
W>W<<WWW^Wv<><W<vWP<v>W
W>W^>^>C<WWWv^W<WWWW<WW
W>W>^W>W^>W<vWW>vCW^C<W
W>WvWWWWvWWWC^WWW>WWWvW
W<W^>W>WvWv^vWW<W^W^vvW
W<W>^^^>vvWW>><>^>>^>vW
WC<<W<W>W<^>^vWv>W^vWCW
WWW<v<^<WWvWW<WWWWvWWvW
W^^<W<W<>^WWP>WP^v>>>GW
WWWWWWWWWWWWWWWWWWWWWWW
