実行時刻: 2024-12-15 12:14:19.718845
episode: 99
step: 98

WWWWWWWWWWWWWWWWWWWWWWW
WS<vvv^^v^vPWPWW<>^W^PW
W>WWWWWWCWWW^>Wv<WWW<WW
W<>><<><^vvvvvW<v^^v<^W
W<WW^W<WWWWvWWvvWWW^>WW
WvW>vWWW<W^^^>W<vWP<v>W
W>Wv>^^C>WWWv^W^WWWW<WW
W>W>vWPW<>WvvWW^vCW^C<W
W>WvWWWW>WWWv^WWW<WWWvW
W<WC^W>WvWv^vWW^W^Wv^vW
W>W<^v>>CvWW>>>>>>>>>vW
WC^>W>W>W^>C<vW>vWvvWvW
WWWv<^^>WWvWW<WWWWvWWvW
WP^<W<W<^PWWP>WP^v>C>GW
WWWWWWWWWWWWWWWWWWWWWWW
