実行時刻: 2024-12-15 12:14:17.973824
episode: 98
step: 70

WWWWWWWWWWWWWWWWWWWWWWW
WS<vvv^^v^vPWPWW<>^W^PW
W>WWWWWW^WWW^>Wv<WWW<WW
W<v>C^v><vvvvvW<v^^v<^W
W<WW^W<WWWW^WWvvWWW^>WW
WvW>vWWW<W^>v>W<vWP<v>W
WvWv>^^C>WWWv^W^WWWW<WW
WvW>vWPW<>WvvWW^vCW^C<W
W>WvWWWW>WWWv^WWW<WWWvW
W<WC^W>WvWv^vWW^W^Wv^vW
W>W<^v>>CvWW>>>>>>>>>vW
WC^>W>W>W^>C<vW>vWvvWvW
WWWv<^^>WWvWW<WWWWvWWvW
WP^<W<W<^PWWP>WP^v>C>GW
WWWWWWWWWWWWWWWWWWWWWWW
