実行時刻: 2024-12-15 12:13:25.880206
episode: 74
step: 267

WWWWWWWWWWWWWWWWWWWWWWW
WSv><^^v<^^PWPWW<>^W^PW
W>WWWWWWCWWW>>Wv<WWW<WW
W<>v^>v^>^^>^vW<v^^v<^W
W<WWvW>WWWWCWWvvWWW^>WW
W>W<vWWW<Wvv<^W<vWP<v>W
W>W<<vvC>WWWv^W<WWWW<WW
W>W<vWPW>>W<vWW>vCW^C<W
W>WvWWWW>WWWC^WWW>WWWvW
W<W^>W>W>Wv^<WW<W^Wv^vW
W<W^^v^>>>WW>^>>>>v>>vW
W<^>W>W>W>>v^>Wv>W^vWvW
WWW<v<^>WWvWW<WWWWvWWvW
W^^<W<W<>^WWP>WP^v>C>GW
WWWWWWWWWWWWWWWWWWWWWWW
