実行時刻: 2024-12-15 14:18:19.459717
episode: 57
step: 117

WWWWWWWWWWWWWWWWWWWWWWW
WS>>>^^>>v^PWPWW^^vW<PW
W>WWWWWWCWWWv<W<^WWW^WW
W<>>^^<<^v^^^vW<<^<><^W
W>WW>W<WWWW^WW^vWWW>vWW
W^W>^WWW^Wv>v<W<^WP^<>W
W>W^>>>CvWWW>vWvWWWW<WW
W>W<>WPW<^WvvWW<^CW^CvW
W>W^WWWW^WWW<>WWW>WWW^W
W>WC<W^W<W<^^WW<W<Wv^vW
W<Wv<vv>C^WWv>>>>^>>>vW
WCvvW<WvW<>C>^WvvWv^WCW
WWW<v>^>WW>WW>WWWW<WWvW
WP<vW<W>vPWWPvWP^<>^>GW
WWWWWWWWWWWWWWWWWWWWWWW
