実行時刻: 2024-12-15 12:14:10.703604
episode: 94
step: 136

WWWWWWWWWWWWWWWWWWWWWWW
WS>^^<^^v^vPWPWW<>^W^PW
W^WWWWWWCWWW^>Wv<WWW<WW
W>>>^^v^<><vvvW<v^^v<^W
W<WW^W<WWWWCWWvvWWW^>WW
WvWv^WWW<W^><^W<vWP<v>W
W>Wvv^v<>WWWvvW^WWWW<WW
W>W<vW>W<>W<<WW^vCW^C<W
W>W^WWWW>WWWC^WWW<WWWvW
W<WC>W>WvWv^^WW^W^Wv^vW
W<Wv^^^>>>WW>>>>>>>>>vW
WC<<W<W>W<><v^W>vWvvWvW
WWWv<^^>WWvWW<WWWWvWWvW
WP^<W<W<^PWWP>WP^v>C>GW
WWWWWWWWWWWWWWWWWWWWWWW
