実行時刻: 2024-12-15 12:13:53.805190
episode: 87
step: 85

WWWWWWWWWWWWWWWWWWWWWWW
WS^v<vv<v^vvWPWW<>^W^PW
WvWWWWWWvWWW^>Wv<WWW<WW
W>>>C^v<<<<vvvW<v^^v<^W
W<WW>W<WWWW^WWvvWWW^>WW
WvW>vWWW<W^^>^W<vWP<v>W
W>W<>^^C>WWW^vW^WWWW<WW
W>W<vWPW>>W<vWW^vCW^C<W
W>WvWWWW>WWW<^WWW<WWWvW
W<WC^W>WvWv^vWW^W^Wv^vW
W<W<vv^>CvWW>>>>>>>>>vW
WC^<W>W>W>>CvvW>vWvvWvW
WWW^<><vWWvWW<WWWWvWWvW
WP^<W<W<vPWWP>WP^v>C>GW
WWWWWWWWWWWWWWWWWWWWWWW
