実行時刻: 2024-12-24 23:05:22.522706
episode: 2
step: 217

WWWWWWWWWWWWWWWWWWWWWWW
WS←↓←→→→→→→PWPWW←→↓W←PW
W←WWWWWWCWWW→→W↑↑WWW↑WW
W←←→↓↑↓↓→↓←↓↓→W↓↑←↑→→↑W
W←WW→W←WWWW↑WW↑←WWW↓→WW
W↓W↑↓WWW↑W↓→↑↑W←↑WP←↑→W
W←W↓↓→→C→WWW↓↓W↑WWWW↑WW
W↓W←↓WPW→↓W↓↓WW↑←CW↑↑←W
W↑W←WWWW→WWW→↑WWW↑WWW↓W
W→WC↑W↓W↓W↑↓→WW←W←W↑→↓W
W←W→↓↓↓→C↓WW→→→→→→↑→→↓W
WC↑←W→W←W→→C↑←W↓↓W↓↓W↓W
WWW←↑↓←↓WW↓WW↑WWWW↓WW↓W
WP↓→W↓W→↑PWW↑→WP↓↑→C→GW
WWWWWWWWWWWWWWWWWWWWWWW
