実行時刻: 2024-12-24 23:05:09.655559
episode: 0
step: 3000

WWWWWWWWWWWWWWWWWWWWWWW
WS←↓←→→→→→→↑WPWW←→↓W←PW
W←WWWWWW←WWW→→W↑↑WWW↑WW
W→→↑C→↓↑→↓↓←↓→W↓↑←↑→→↑W
W→WW→W←WWWWCWW↑←WWW↓→WW
W↓W↑→WWW↑W↑←↑↓W←↑WP←↑→W
W←W←↑↑↓C←WWW↑←W↑WWWW←WW
W↓W↑→WPW→↓W↓↓WW↑←CW↑C→W
W↑W↑WWWW→WWWC↑WWW↑WWW←W
W→WC↓W→W↓W←↓←WW←W←W→→↓W
W←W↓←↓↑↑C↓WW→→C→→→→→→↓W
WC↓→W→W→W→→C↑↑W↓→W↓↓WCW
WWW↓↑←↑↑WW↓WW←WWWW↓WW↓W
WP↓↓W↓W↓↑PWWP↓WP↓↑→C→GW
WWWWWWWWWWWWWWWWWWWWWWW
