実行時刻: 2024-12-15 14:18:31.294544
episode: 61
step: 163

WWWWWWWWWWWWWWWWWWWWWWW
WSv^^^^v^^^PW^WW^^vW<PW
WvWWWWWW^WWWv<W<^WWW^WW
Wvv>C<v^<^^vvvW<<^<><^W
W<WW^W>WWWW>WW^<WWW>vWW
W^W^>WWW>W<v^^W<^WP^<>W
W>W<v^^C<WWW^^W>WWWW<WW
W>W<vWPW>^Wv<WW<<CW^CvW
W>W<WWWW>WWWv>WWW>WWW^W
W>WC<W^WvW<^vWW<W>Wv^vW
W<Wv<vv^C^WW^>>v>>>>>vW
WCvvW<WvW<^CvvWv>Wv^WCW
WWW<v>^>WW<WW>WWWWvWWvW
WP<vW<W>vPWWPvWP^<>>>GW
WWWWWWWWWWWWWWWWWWWWWWW
