実行時刻: 2024-12-15 14:18:13.197102
episode: 55
step: 208

WWWWWWWWWWWWWWWWWWWWWWW
WSv<^^^^>v^PWPWW^^vW<PW
W>WWWWWWCWWWv<W<^WWW^WW
Wv>>>>v^v<^v^vW<<^<><^W
W>WW>W<WWWWCWW^vWWW>vWW
W<W^<WWW^W^v>>W<^WP^<>W
W<W<<>>vvWWWvvWvWWWW<WW
W<W>^W>W>^WvvWW<^CW^CvW
W<WvWWWW<WWWC>WWW>WWW^W
W<W>>W^W>W<^vWW<W<W^>vW
W>Wv^><>^vWW^v^>>>>^>vW
WC^<W<WvW^>^vvW^vW>>WvW
WWWvv>^>WW>WW>WWWWvWWvW
WP<vW<W>vPWWP<WP^<>C>GW
WWWWWWWWWWWWWWWWWWWWWWW
