実行時刻: 2024-12-15 12:14:14.823119
episode: 96
step: 137

WWWWWWWWWWWWWWWWWWWWWWW
WSv<v<v>v^vPWPWW<>^W^PW
WvWWWWWWCWWW^>Wv<WWW<WW
Wv><<^v>>^^vvvW<v^^v<^W
W<WW<W<WWWWCWWvvWWW^>WW
WvWv<WWW<W^<>^W<vWP<v>W
W>Wv<^vC>WWWv^W^WWWW<WW
W>W^>WPW<>W<<WW^vCW^C<W
W>W>WWWW>WWWC^WWW<WWWvW
W<Wv^W>WvWv^vWW^W^Wv^vW
W>Wv>>v>^^WW>>>>>>>>>vW
W<^>W>W>W>>>vvW>vWvvWvW
WWWv<^^>WWvWW<WWWWvWWvW
WP^<W<W<^PWWP>WP^v>C>GW
WWWWWWWWWWWWWWWWWWWWWWW
