実行時刻: 2024-12-15 14:18:44.608406
episode: 65
step: 209

WWWWWWWWWWWWWWWWWWWWWWW
WS^^vv<<<^^vW^WW^^vW<PW
W<WWWWWW^WWWv<W<^WWW^WW
W<<><<<<vv^^vvW<<^<><^W
WvWW>W<WWWW<WW^<WWW>vWW
W>W^<WWW>W^>v>W<^WP^<>W
W>W<<<vC>WWWv>W>WWWW<WW
W<W^<WPW^^WvvWW<<CW^CvW
W<WvWWWWvWWWv>WWW^WWW^W
W^WC^W^WvW<^>WW<W>Wv^vW
WvW>v>^<CvWW>>^>>>v^^vW
WCv^W^W>Wv>CvvWv<Wv^WvW
WWW^<^v<WW<WW>WWWWvWWvW
WP<<W>W>^PWWPvWP^<>C>GW
WWWWWWWWWWWWWWWWWWWWWWW
