実行時刻: 2024-12-15 12:13:13.964398
episode: 70
step: 175

WWWWWWWWWWWWWWWWWWWWWWW
WSv^^vv<v^^PWPWW<>^W^PW
WvWWWWWWCWWW<vWv<WWW<WW
W<^><^<<^<v>v>W<v^^v<^W
W<WW>W<WWWWCWWvvWWW^>WW
W>W>vWWW^Wv<><W<vWP<v>W
W>W<<^^C<WWWv^W<WWWW<WW
W>W>vWPW^>W<vWW>vCW^C<W
W>W^WWWWvWWWC^WWW>WWWvW
W<W<^W>WvWv^vWW<W^W^vvW
W<Wv<>>><>WW>>>>>>v^>vW
W<^vW^WvWv^<<^Wv>WvvWvW
WWW^vv^>WW<WW<WWWWvWWvW
W^^<W<W<>PWWP>WP^v>C>GW
WWWWWWWWWWWWWWWWWWWWWWW
