実行時刻: 2024-12-15 12:14:05.592813
episode: 92
step: 114

WWWWWWWWWWWWWWWWWWWWWWW
WS^^^<^^v^vPWPWW<>^W^PW
WvWWWWWWCWWW^>Wv<WWW<WW
Wvv>>>>>vv^<vvW<v^^v<^W
W<WW>W<WWWWCWWvvWWW^>WW
WvW><WWW<W^>^^W<vWP<v>W
W>Wv<<>C>WWWvvW^WWWW<WW
W>W^vWPW<>W<vWW^vCW^C<W
W>W^WWWW<WWWC^WWW<WWWvW
W<W^>W>W<Wv^<WW^W^Wv^vW
W<Wv^^^><vWW>>>>>>>>>vW
WC<<W<W>Wvv>>^W>vWvvWvW
WWWv<^^>WWvWW<WWWWvWWvW
WP^<W<W<^PWWP>WP^v>C>GW
WWWWWWWWWWWWWWWWWWWWWWW
