実行時刻: 2024-12-15 14:18:25.847964
episode: 59
step: 161

WWWWWWWWWWWWWWWWWWWWWWW
WS^vvv<<v^^PWPWW^^vW<PW
W>WWWWWWCWWWv<W<^WWW^WW
W<^><>v^>v^^^vW<<^<><^W
W<WW^W<WWWWCWW^<WWW>vWW
W^W^>WWW>Wv>v<W<^WP^<>W
W>W<v^^v<WWW>vW>WWWW<WW
W>W<vW>W>^WvvWW<<CW^CvW
W>W<WWWW>WWWC>WWW>WWW^W
W>WC<W^WvW<^^WW<W>Wv^vW
W<Wv<vv^<^WW>^<^v>><>vW
WCvvW<WvW<^<vvWvvW<^WCW
WWW<v>^>WW<WW>WWWWvWWvW
WP<vW<W>vPWWPvWP^<>>>GW
WWWWWWWWWWWWWWWWWWWWWWW
