実行時刻: 2024-12-15 12:14:08.340539
episode: 93
step: 163

WWWWWWWWWWWWWWWWWWWWWWW
WS^^^<^^v^vPW^WW<>^W^PW
WvWWWWWWCWWW^>Wv<WWW<WW
W^v><^v^<><vvvW<v^^v<^W
W<WW>W<WWWW<WWvvWWW^>WW
WvW><WWW<W^><^W<vWP<v>W
W>Wv<<>C>WWWvvW^WWWW<WW
W>W^vWPW<>W<<WW^vCW^C<W
W>W^WWWW<WWWv^WWW<WWWvW
W<WC>W>W<Wv^^WW^W^Wv^vW
W<Wv^^^>CvWW>>><>>>>>vW
WC<<W<W>WvvC>^W>vWvvWvW
WWWv<^^>WWvWW<WWWWvWWvW
WP^<W<W<^PWWP>WP^v>C>GW
WWWWWWWWWWWWWWWWWWWWWWW
