実行時刻: 2024-12-15 12:13:42.187447
episode: 81
step: 81

WWWWWWWWWWWWWWWWWWWWWWW
WS>vv^v^^^vPWPWW<>^W^PW
W>WWWWWWCWWW^>Wv<WWW<WW
Wv>>vvv<vv<vvvW<v^^v<^W
W<WW<W<WWWW^WWvvWWW^>WW
WvW>vWWW^Wv^v<W<vWP<v>W
WvW^<vvC^WWW>>W^WWWW<WW
W<W>^WPW<>W<vWW^vCW^C<W
W>WvWWWW<WWW<^WWW<WWWvW
W<WC<W>WvWv^vWW^W^Wv^vW
W<Wv<><>C^WW>>>>>>>>>vW
WC^<W<W>W>>C<^W>vWvvWCW
WWW<v<<vWWvWW<WWWWvWWvW
WP^<WvW<vPWWP>WP^v>>>GW
WWWWWWWWWWWWWWWWWWWWWWW
