実行時刻: 2024-12-15 12:13:34.260336
episode: 77
step: 148

WWWWWWWWWWWWWWWWWWWWWWW
WS^><^>vv^vPW^WW<>^W^PW
W>WWWWWWCWWW^>Wv<WWW<WW
W^>><<^<>vvvvvW<v^^v<^W
W<WW>W>WWWW<WWvvWWW^>WW
WvW<>WWW^WvvvvW<vWP<v>W
W>W^^^vC^WWWvvW^WWWW<WW
W<Wv<WPW<>W<>WW^vCW^C<W
W>WvWWWW<WWWv^WWW<WWWvW
W<WC>W>WvWv^>WW^W^Wv^vW
W<W^^v^>CvWW>>>>>>>>>vW
WC^>W>W>W<>C>>Wv>WvvWvW
WWW<v<^>WWvWW<WWWWvWWvW
WP^<W<W<>PWWP>WP^v>C>GW
WWWWWWWWWWWWWWWWWWWWWWW
