実行時刻: 2024-12-15 14:18:39.275877
episode: 63
step: 155

WWWWWWWWWWWWWWWWWWWWWWW
WSv>>v>v^^^PWPWW^^vW<PW
W>WWWWWWCWWWv<W<^WWW^WW
W>>>>vv^<^^vvvW<<^<><^W
WvWW^W>WWWWCWW^<WWW>vWW
W>W^<WWW>W<v^^W<^WP^<>W
W>W<<<v^>WWW^^W>WWWW<WW
W<W^<W>W^^Wv<WW<<CW^CvW
W<WvWWWWvWWWC>WWW>WWW^W
W^WC^W^WvW<^<WW<W>Wv^vW
WvW>v>^<<vWWv>>>>>>>>vW
WCv^W^W>Wv><>>Wv<Wv^WCW
WWW^<^v<WW<WW>WWWWvWWvW
WP<<W>W>^PWWPvWP^<>>>GW
WWWWWWWWWWWWWWWWWWWWWWW
