実行時刻: 2024-12-15 14:18:46.996233
episode: 66
step: 142

WWWWWWWWWWWWWWWWWWWWWWW
WS>^v^^<<^^PWPWW^^vW<PW
W<WWWWWWCWWWv<W<^WWW^WW
W<>>><<<vv^^vvW<<^<><^W
W>WW>W<WWWWCWW^<WWW>vWW
WvW>vWWW>W^>v>W<^WP^<>W
W>W>><vC>WWWv>W>WWWW<WW
W<W><WPW^^WvvWW<<CW^CvW
W<WvWWWWvWWWC>WWW^WWW^W
W^W^>W^W<W<^>WW<W>Wv^vW
WvW^<v^><>WW>>v>>>>^^vW
WCv>W^W<W>>^<vWv<Wv^WCW
WWW^<^v<WW<WW>WWWWvWWvW
WP<<W>W>^PWWPvWP^<>>>GW
WWWWWWWWWWWWWWWWWWWWWWW
