実行時刻: 2024-12-15 14:18:52.455241
episode: 68
step: 132

WWWWWWWWWWWWWWWWWWWWWWW
WSvvv^v^v^^vWPWW^^vW<PW
W>WWWWWW^WWW<<W<^WWW^WW
Wv^vC^vv><^vvvW<<^<><^W
W>WW<W<WWWW>WW^<WWW>vWW
WvW>vWWW>W^<^>W<^WP^<>W
W>W>><vC>WWWv>W>WWWW<WW
W<W><WPW^^WvvWW<<CW^CvW
W<WvWWWWvWWW^>WWW^WWW^W
W^WC>W^W<W<<vWW<W>W<vvW
WvW^<v^>C>WW>>>>>>>>>vW
WCv>W^W<W>>C<vW><Wv^WCW
WWW^<^v<WW<WW>WWWWvWWvW
WP<<W>W>^PWWPvWP^<>>>GW
WWWWWWWWWWWWWWWWWWWWWWW
