実行時刻: 2024-12-15 12:13:21.397278
episode: 73
step: 97

WWWWWWWWWWWWWWWWWWWWWWW
WS^v<^^v<^^PWPWW<>^W^PW
W^WWWWWWCWWW>>Wv<WWW<WW
W>v>>^vv>^^>^vW<v^^v<^W
W<WW<W<WWWWCWWvvWWW^>WW
W>Wv>WWW<Wvv<^W<vWP<v>W
W>W^vvv^>WWWv^W<WWWW<WW
W>W>^WPW>>W<vWW>vCW^C<W
W>WvWWWW>WWWC^WWW>WWWvW
W<WC>W>WvWv^>WW<W^Wv^vW
W<W>^^^<<vWWv><>>>>>>vW
WC<<W<W>W<><^>Wv>W^vWvW
WWW<v<^<WWvWW<WWWWvWWvW
WP^<W<W<>PWWv>WP^v>C>GW
WWWWWWWWWWWWWWWWWWWWWWW
