実行時刻: 2024-12-15 12:13:31.736026
episode: 76
step: 185

WWWWWWWWWWWWWWWWWWWWWWW
WSv^<^>vv^vPWPWW<>^W^PW
WvWWWWWWCWWW^>Wv<WWW<WW
W^v>>>v^v>v^^vW<v^^v<^W
WvWW>W>WWWWCWWvvWWW^>WW
W>W<>WWW^Wv>>^W<vWP<v>W
WvW^^^vv^WWWv^W^WWWW<WW
W>Wv<W>W<>W<vWW^v>W^C<W
W>WvWWWW<WWWC^WWW<WWWvW
W<WC>W>WvWv^^WW<W^Wv^vW
W<W^^v^>^vWW>>v^>>>>>vW
WC^>W>W>W<>^>>Wv>WvvWvW
WWW<v<^>WWvWW<WWWWvWWvW
WP^<W<W<>PWWP>WP^v>C>GW
WWWWWWWWWWWWWWWWWWWWWWW
