実行時刻: 2024-12-15 14:18:04.463139
episode: 52
step: 444

WWWWWWWWWWWWWWWWWWWWWWW
WSvv<vv<<^^PWPWW^^vW<PW
WvWWWWWWCWWW^vW<^WWW^WW
Wvv>><>v>>^^^vW<<^<><^W
W>WW<W<WWWWCWW^vWWW>vWW
W<W<<WWW^W^<v<W<^WP^<>W
W>Wv<<>CvWWW<vWvWWWW<WW
W^W^>WPW>^WvvWW<^CW^CvW
W>W<WWWW<WWWC>WWW>WWW^W
W<W>vW^W^W<^<WW<W<W^>vW
W<W^v^<>^>WW<><>^>>>>vW
W<^<W>W<W>v<>>W^vWv>WCW
WWWvv>>^WW>WW>WWWWvWWvW
W<<vW<W>v>WW<<WP^<>>>GW
WWWWWWWWWWWWWWWWWWWWWWW
