実行時刻: 2024-12-15 14:18:09.720332
episode: 54
step: 148

WWWWWWWWWWWWWWWWWWWWWWW
WS^<^^^^>v^PWPWW^^vW<PW
W^WWWWWW>WWWv<W<^WWW^WW
W<v>^^v^v<^v^vW<<^<><^W
W>WW<W<WWWW^WW^vWWW>vWW
W<W^vWWW^W^v>>W<^WP^<>W
W<Wv<<>CvWWWvvWvWWWW<WW
W<W^>WPW>^WvvWW<^CW^CvW
W<W<WWWW<WWW>>WWW>WWW^W
W<WCvW^W^W<^vWW<W<W^>vW
W>W^v^<>C>WW^><>>>>>>vW
WC^<W>W<W>vC>>W^vW>>WCW
WWWvv>>^WW>WW>WWWWvWWvW
WP<vW<W>vPWWP<WP^<>>>GW
WWWWWWWWWWWWWWWWWWWWWWW
