実行時刻: 2024-12-24 23:06:21.152425
episode: 20
step: 492

WWWWWWWWWWWWWWWWWWWWWWW
WS←↑←→→↓↑↑→PWPWW←→→W→↓W
W↓WWWWWWCWWW←↓W↓→WWW←WW
W→→→C↑↓↑↓↓→↓→↑W↓↑←↑→→↓W
W→WW↓W↓WWWWCWW↓↓WWW↑↓WW
W↓W↑→WWW→W↓→↑←W↓→W↓→←↓W
W↑W→↓↓→C←WWW↓→W→WWWW←WW
W←W→←WPW→→W↑↓WW↓↓↓W↑↓↓W
W←W↓WWWW↓WWWC↓WWW↑WWW←W
W↓WC→W→W↓W↑←↓WW→W→W↑→↓W
W↓W↓→→↓→→↑WW→→→→→→↓→→↓W
W←←←W↑W↑W→→←→↑W←→W↓↑W↓W
WWW←←↑↑←WW←WW←WWWW↓WW↓W
WP↑←W→W→↑↓WWP←WP↓→→C→GW
WWWWWWWWWWWWWWWWWWWWWWW
