実行時刻: 2024-12-24 23:05:35.871732
episode: 5
step: 205

WWWWWWWWWWWWWWWWWWWWWWW
WS←↑←→→→→→→PW→WW←→↓W←PW
W→WWWWWWCWWW→→W↑↑WWW↑WW
W←→→↓↑→→→→↑→↑→W↓↑←↑→→↑W
W←WW→W←WWWW↑WW↑←WWW↓→WW
W↑W↑→WWW↑W←←←→W←↑WP←↑→W
W←W↓↓→→C→WWW↑→W↑WWWW↑WW
W→W↓→WPW→↓W↓↓WW↑←CW↑C←W
W←W↓WWWW↑WWW↓↓WWW↑WWW↓W
W←WC↑W→W←W↑↓←WW→W←W↑→↓W
W←W←↓→→→C←WW→→→→→→↓→→↓W
WC→←W→W←W←→C→↓W→↑W↓↓WCW
WWW↓←↓↓←WW→WW↑WWWW↓WW↓W
WP←→W↓W→↑PWWP→WP↓↑→→→GW
WWWWWWWWWWWWWWWWWWWWWWW
