実行時刻: 2024-12-24 23:06:10.150767
episode: 18
step: 82

WWWWWWWWWWWWWWWWWWWWWWW
WS←↑←→→↓↑→→PWPWW←→↓W←PW
W↓WWWWWWCWWW←↓W↑↑WWW↑WW
W←←→→↑←↑→↓↑↓→↑W↓↑←↑→→↑W
W↑WW←W←WWWWCWW↑←WWW↓→WW
W↑W↑↑WWW→W↓↓←↑W←↑WP←↑→W
W←W→↓↓→↓←WWW←↓W↑WWWW↑WW
W↓W→←W↓W→→W↑←WW↑←CW↑C←W
W→W↓WWWW↓WWWC↓WWW↑WWW↓W
W→WC→W→W↓W↑←↓WW→W←W↑→↓W
W↓W↓→→↓↑↑↓WW→→→→→→↓→→↓W
WC←→W→W←W→→→→↑W←→W↓↑WCW
WWW→→↓→↓WW←WW←WWWW↓WW↓W
WP↑←W→W→↑PWWP←WP↓→→→→GW
WWWWWWWWWWWWWWWWWWWWWWW
