実行時刻: 2024-12-15 14:17:57.115746
episode: 51
step: 265

WWWWWWWWWWWWWWWWWWWWWWW
WSvv<vv<<^^^W>WW^^vW<PW
WvWWWWWW<WWW^vW<^WWW^WW
W<^^<<>v>>^^^vW<<^<><^W
W>WW>W<WWWW<WW^vWWW>vWW
W<W^<WWW^W^<v<W<^WP^<>W
W<W<^<><vWWW<vWvWWWW<WW
W^WvvWPW>^WvvWW<^CW^CvW
W>W<WWWW>WWWC>WWW>WWW^W
W>WC<W^W^W<^<WW<W<W^>vW
W<Wvv^^v<^WW><v>>>v>>vW
WCv>WvW<W>><^vW^vWv>WCW
WWW^^<^<WW>WW>WWWWvWWvW
WP^vWvW>vPWWP<WP^<>v>GW
WWWWWWWWWWWWWWWWWWWWWWW
