実行時刻: 2024-12-15 12:13:58.111232
episode: 89
step: 161

WWWWWWWWWWWWWWWWWWWWWWW
WS>v<vv<v^vPWPWW<>^W^PW
WvWWWWWWCWWW^>Wv<WWW<WW
W>>>>^v<<<<vvvW<v^^v<^W
W<WW^W<WWWWCWWvvWWW^>WW
WvW><WWW^W^^>^W<vWP<v>W
W>W^><>C<WWW^vW^WWWW<WW
W>W>^WPW<>W<vWW^vCW^C<W
W>W^WWWW<WWWC^WWW<WWWvW
W<Wv<W>WvWv^vWW^W^Wv^vW
W<W^v>v>^^WW>>>>>>>>>vW
WC<<W<W>W>><^^W>vWvvWvW
WWWv<^^>WWvWW<WWWWvWWvW
WP^<W<W<^^WWP>WP^v>C>GW
WWWWWWWWWWWWWWWWWWWWWWW
