実行時刻: 2024-12-15 12:13:35.720729
episode: 78
step: 84

WWWWWWWWWWWWWWWWWWWWWWW
WSv<v^v^^^vPWPWW<>^W^PW
W>WWWWWW>WWW^>Wv<WWW<WW
W^>>C<^<<>^vvvW<v^^v<^W
W<WW>W>WWWWvWWvvWWW^>WW
WvW<>WWW^Wv<^<W<vWP<v>W
W>W^^^vC^WWW<>W^WWWW<WW
W<Wv<WPW<>W<vWW^vCW^C<W
W>WvWWWW<WWW>^WWW<WWWvW
W<WC>W>WvWv^<WW^W^Wv^vW
W<W^^v^>CvWW>><>>>>>>vW
WC^>W>W>W<>C>>Wv>WvvWvW
WWW<v<^>WWvWW<WWWWvWWvW
WP^<W<W<>PWWP>WP^v>C>GW
WWWWWWWWWWWWWWWWWWWWWWW
