実行時刻: 2024-12-15 12:13:38.263470
episode: 79
step: 150

WWWWWWWWWWWWWWWWWWWWWWW
WSv<v^v^^^vPWPWW<>^W^PW
W>WWWWWWCWWW^>Wv<WWW<WW
Wv>><^^<<>^vvvW<v^^v<^W
W<WW>W>WWWWCWWvvWWW^>WW
WvW<>WWW^Wv<^<W<vWP<v>W
W>W<>^vC^WWW<>W^WWWW<WW
W<W><WPW<>W<vWW^vCW^C<W
W>W^WWWW<WWWC^WWW<WWWvW
W<W^vW>WvWv^<WW^W^Wv^vW
W<Wvv^<><>WW>>>>v>>>>vW
WC^<W>W>W>>>v^Wv>WvvWvW
WWW<v>^^WWvWW<WWWWvWWvW
W^^<WvW<>PWWP>WP^v>C>GW
WWWWWWWWWWWWWWWWWWWWWWW
