実行時刻: 2024-12-15 12:14:12.402804
episode: 95
step: 94

WWWWWWWWWWWWWWWWWWWWWWW
WSv<v<v>v^vPWPWW<>^W^PW
WvWWWWWW>WWW^>Wv<WWW<WW
W>>>C^vv>^^vvvW<v^^v<^W
W<WW^W<WWWWvWWvvWWW^>WW
WvWv^WWW<W^<>^W<vWP<v>W
W>Wvv^vC>WWWv^W^WWWW<WW
W>W<vWPW<>W<<WW^vCW^C<W
W>W^WWWW>WWWv^WWW<WWWvW
W<WC>W>WvWv^vWW^W^Wv^vW
W<Wv^^^>C>WW>>>>>>>>>vW
WC<<W<W>W<>Cv^W>vWvvWvW
WWWv<^^>WWvWW<WWWWvWWvW
WP^<W<W<^PWWP>WP^v>C>GW
WWWWWWWWWWWWWWWWWWWWWWW
