実行時刻: 2024-12-15 12:13:19.736826
episode: 72
step: 127

WWWWWWWWWWWWWWWWWWWWWWW
WS^v<^^v<^^PW^WW<>^W^PW
W>WWWWWW^WWW>>Wv<WWW<WW
W>>vC^vv>^^>^vW<v^^v<^W
W<WW>W<WWWW^WWvvWWW^>WW
W>W<<WWW^Wvv<^W<vWP<v>W
W>W^>^>C<WWWv^W<WWWW<WW
W>W>^WPW^>W<vWW>vCW^C<W
W>WvWWWWvWWW^^WWW>WWWvW
W<WC>W>WvWv^>WW<W^Wv^vW
W<W>^^^>CvWW>>>>>>>>>vW
WC<<W<W>W<^C^vWv>W^vWvW
WWW<v<^<WWvWW<WWWWvWWvW
WP^<W<W<>PWWP>WP^v>C>GW
WWWWWWWWWWWWWWWWWWWWWWW
