実行時刻: 2024-12-15 12:13:46.758515
episode: 84
step: 72

WWWWWWWWWWWWWWWWWWWWWWW
WSvvvvvvv^^PWPWW<>^W^PW
W^WWWWWW>WWW^>Wv<WWW<WW
W>>>Cv<v^^>vvvW<v^^v<^W
W<WW^W<WWWW^WWvvWWW^>WW
WvWv>WWW<W^v^^W<vWP<v>W
W>Wv^^^C>WWWvvW^WWWW<WW
W>W>^WPW>>W<vWW^vCW^C<W
W>WvWWWW>WWW>^WWW<WWWvW
W<WC<W>WvWv^vWW^W^Wv^vW
W<Wv<><>CvWW>>>>>>>>>vW
WC^<W<W>W>>C>^W>vWvvWvW
WWW<v<<vWWvWW<WWWWvWWvW
WP^<WvW<vPWWP>WP^v>C>GW
WWWWWWWWWWWWWWWWWWWWWWW
