実行時刻: 2024-12-15 12:14:00.000826
episode: 90
step: 110

WWWWWWWWWWWWWWWWWWWWWWW
WS>v<vv<v^vPWPWW<>^W^PW
WvWWWWWWCWWW^>Wv<WWW<WW
W>vv<vv<<<<vvvW<v^^v<^W
W<WW<W<WWWWCWWvvWWW^>WW
WvW>vWWW<W^^>^W<vWP<v>W
W>Wvv<><>WWW^vW^WWWW<WW
W>W<<WPW<>W<vWW^vCW^C<W
W>W<WWWWvWWWC^WWW<WWWvW
W<WC<W>W>Wv^vWW^W^Wv^vW
W<W^v>v>^<WW>>>>>><>>vW
WC<<W<W>W>v<>^W>vWvvWvW
WWWv<^^>WWvWW<WWWWvWWvW
WP^<W<W<^PWWP>WP^v>C>GW
WWWWWWWWWWWWWWWWWWWWWWW
