実行時刻: 2024-12-15 12:13:45.495050
episode: 83
step: 94

WWWWWWWWWWWWWWWWWWWWWWW
WS^v^^^^v^^PWPWW<>^W^PW
W^WWWWWWCWWW^>Wv<WWW<WW
W>>><vv<<vvvvvW<v^^v<^W
W<WW^W<WWWWCWWvvWWW^>WW
WvWv>WWW<Wv><<W<vWP<v>W
W>Wv^^^^>WWWvvW^WWWW<WW
W>W>^W>W>>W<vWW^vCW^C<W
W>WvWWWW>WWWC^WWW<WWWvW
W<WC<W>WvWv^>WW^W^Wv^vW
W<Wv<><>^vWW>><>>>>>>vW
WC^<W<W>W>>^>^W>vWvvWvW
WWW<v<<vWWvWW<WWWWvWWvW
WP^<WvW<vPWWP>WP^v>C>GW
WWWWWWWWWWWWWWWWWWWWWWW
