実行時刻: 2024-12-15 12:13:52.332563
episode: 86
step: 157

WWWWWWWWWWWWWWWWWWWWWWW
WS>^^v^v>^vvWPWW<>^W^PW
WvWWWWWW^WWW^>Wv<WWW<WW
W>>><^v<vv^vvvW<v^^v<^W
W<WW>W<WWWW^WWvvWWW^>WW
WvW>vWWW<W^>v^W<vWP<v>W
W>W<>^^C>WWWvvW^WWWW<WW
W>W<vWPW>>W<vWW^vCW^C<W
W>WvWWWW>WWWv^WWW<WWWvW
W<WC^W>WvWv^vWW^W^Wv^vW
W<W<vv^>CvWW>>>>>>>>>vW
WC^<W>W>W>>CvvW>vWvvWvW
WWW^<><vWWvWW<WWWWvWWvW
WP^<W<W<vPWWP>WP^v>C>GW
WWWWWWWWWWWWWWWWWWWWWWW
