実行時刻: 2024-12-15 12:13:43.876418
episode: 82
step: 98

WWWWWWWWWWWWWWWWWWWWWWW
WS^v^^^^v^^vWPWW<>^W^PW
W>WWWWWW^WWW^>Wv<WWW<WW
Wv>>Cvv<<vvvvvW<v^^v<^W
W<WW<W<WWWWvWWvvWWW^>WW
WvW>vWWW^Wv><<W<vWP<v>W
WvW^<vvC^WWWvvW^WWWW<WW
W<W>^WPW<>W<vWW^vCW^C<W
W>WvWWWW<WWW^^WWW<WWWvW
W<WC<W>WvWv^>WW^W^Wv^vW
W<Wv<><>C^WW>>>>>v>>>vW
WC^<W<W>W>>C<^W>vWvvWvW
WWW<v<<vWWvWW<WWWWvWWvW
WP^<WvW<vPWWP>WP^v>C>GW
WWWWWWWWWWWWWWWWWWWWWWW
