実行時刻: 2024-12-15 14:18:50.221561
episode: 67
step: 194

WWWWWWWWWWWWWWWWWWWWWWW
WS>^v^<<^^^vW^WW^^vW<PW
W>WWWWWW>WWW<<W<^WWW^WW
Wv^v^^v^<v<vvvW<<^<><^W
W>WW<W<WWWW>WW^<WWW>vWW
WvW>vWWW>W^^^>W<^WP^<>W
W>W>><vC>WWW>>W>WWWW<WW
W<W><WPW^^WvvWW<<CW^CvW
W<WvWWWWvWWW<>WWW^WWW^W
W^WC>W^W<W<<^WW<W>W<vvW
WvW^<v^>C>WW>><v>>v>>vW
WCv>W^W<W>>C<vWv<Wv^WvW
WWW^<^v<WW<WW>WWWWvWWvW
WP<<W>W>^PWWPvWP^<>C>GW
WWWWWWWWWWWWWWWWWWWWWWW
