実行時刻: 2024-12-24 23:06:23.902895
episode: 22
step: 69

WWWWWWWWWWWWWWWWWWWWWWW
WS←↑←→→↓↑↑→PWPWW←→→W→PW
W↓WWWWWWCWWW←↑W↓→WWW←WW
W→→→↓←↓↓→→→→↓→W↓↑←↑→→↓W
W→WW←W←WWWWCWW↓↓WWW↑↓WW
W↓W→↓WWW→W↓→↓→W↓→WP→←↓W
W↑W→→↓→C←WWW↓↓W→WWWW←WW
W←W←↓WPW→→W↑↓WW↓↓CW↑C↓W
W←W↓WWWW↓WWWC↓WWW↑WWW←W
W↓W←↑W→W↓W↑←↓WW→W→W↑→↓W
W↓W↓←→↑→←↑WW→→→→→→↓→→↓W
WC←←W↑W↑W→→→→→W←→W↓↑WCW
WWW←←↑↑←WW←WW←WWWW↓WW↓W
WP↑←W→W→↑PWWP←WP↓→→→→GW
WWWWWWWWWWWWWWWWWWWWWWW
