実行時刻: 2024-12-15 14:18:36.659132
episode: 62
step: 323

WWWWWWWWWWWWWWWWWWWWWWW
WSv^^^^v^^^PWPWW^^vW<PW
W>WWWWWWCWWWv<W<^WWW^WW
W^>vvvv^<^^vvvW<<^<><^W
W<WW<W>WWWWCWW^<WWW>vWW
W>W^>WWW>W<v^^W<^WP^<>W
W>W<v^^C<WWW^^W>WWWW<WW
W<W>vWPW>^Wv<WW<<CW^CvW
W<W<WWWW>WWWC>WWW>WWW^W
W^Wv^W^WvW<^vWW<W>Wv^vW
WvW>v>^<^^WW^>>>>><>>vW
W^v^W^W>W<>^^>Wv<Wv^WvW
WWW^<^v<WW<WW>WWWWvWWvW
W<<<W>W>^>WW^vWP^<>C>GW
WWWWWWWWWWWWWWWWWWWWWWW
