実行時刻: 2024-12-15 12:13:28.638888
episode: 75
step: 164

WWWWWWWWWWWWWWWWWWWWWWW
WSv^<^>vv^vvW^WW<>^W^PW
W>WWWWWW>WWW^>Wv<WWW<WW
W<>vC>v^v>v^^vW<v^^v<^W
W<WWvW>WWWW^WWvvWWW^>WW
W>W<vWWW<Wv>>^W<vWP<v>W
W>W<<vvC>WWWv^W<WWWW<WW
W>W<vWPW>>W<vWW>vCW^C<W
W>WvWWWW>WWW>^WWW>WWWvW
W<WC>W>W>Wv^^WW<W^Wv^vW
W<W^^v^>C>WW<>>>>^>>>vW
WC^>W>W>W>>C^>Wv>WvvWvW
WWW<v<^>WWvWW<WWWWvWWvW
WP^<W<W<>PWWP>WP^v>C>GW
WWWWWWWWWWWWWWWWWWWWWWW
